Adviser of Indifi Technologies                                                  -       Rajnish Kumar
Which first indian appointed as CIA Chief Technology Officer                    -       Nand Mulchandani
PM Adviser in PMO                                                               -       Tarun Kapoor
Director General of Air Force                                                   -       Sanjeev Kapoor
Lokpal President                                                                -       Present - Pradeep Kumar Mohanti, First - Lokpal President Pinaki Chandra Ghosh(8 members)(2019), 5years/75 years age
International Boxing Association(IBA) Athlete Committee Head                    -       Lavleena Borgohain, Member Shiv Thapa
President of Press counsil of India                                             -       Ranjana Prakash Desai
US White house office of Science and Technology Director who                    -       Aarti Prabhakar, First non-White
WTO first woman chairman                                                        -       Nagoji Onkaja Ovela Nigerian
Hindustan Petroleum Corporation Limited Chairman and MD                         -       Pushpa Kumar Joshi, jhukega nahi
Attorney General of India                                                       -       K.K. Venugopal
NHRC Head                                                                       -       Arun Kumar Mishra
NCSC National commision for Scheduled caste President                           -       Vijay Saampla
NCSC National commision for Scheduled tribe President                           -       Harsh Kumar
Finance Commission Chairman                                                     -       NK Singh
31st UPSC President                                                             -       Manoj Soni in place of Pradeep Kumar
Chief Election Commisioner                                                      -       Rajeev Kumar
Foreign Secretary                                                               -       Vinay Mohan Quatra 
CGA                                                                             -       Sonali Singh 
CAG                                                                             -       Murmu 
Central Vigilance Commission                                                    -       Suresh Patel, Santhanam Committee, 2003 Act Legal Body
National Women Commission(Legal body 1990) President                            -       Rekha Sharma
National Commission for Minorities(Legal Body)
National Human right commission(Legal Body)                                     -       Arun Kumar Mishra
Niti Aayog(Legal Body)
Supreme Court Chief Judge                                                       -       NV Ramana 
Commission for Agricultural Costs and Prices Head                               -       Vijay Paul
President of India                                                              -       Draupadi Murmu, Min 35 years
                                                                                        Part-5, Article 52
                                                                                        53 - Powers, 54 - Electing people, 
                                                                                        55 - Method of Election, 56 - Tenure 
                                                                                        61 - Impeachment, 72 - 
International Hockey Federation Temporary President                             -       Saif Ahmed(Egypt) in place of Narinder Batra
International Olympic Association head                                          -       Thomas Waug
ICC head                                                                        -       Greg Bercley
NDA Vice-President                                                              -       Jagdish Dhankad
CBDT Chairman                                                                   -       Nitin Gupta
Chief Economist of World Bank                                                   -       Indermeet Gill 
LIC HFL Board Additional Director                                               -       Ravi Kishan Takkar 
Paytm Payments Service Ltd CEO                                                  -       Nakul Jain 
Indian Deaf Cricket Association CEO                                             -       Roma Balwani 
Vodafone CEO                                                                    -       Akshaya Moondra 
Delhi Police Commissioner                                                       -       Sanjay Arora 
Tata Projects Ltd MD                                                            -       Vinayak Pai 
PIB DG                                                                          -       Satyendra Prakash
Power Grid Corporation CFO                                                      -       Pramod Kumar 
Infrastructure Leasing & Financial Services President                           -       CS Rajan 
Railway Board President and CEO                                                 -       Vinay Kumar Tripathi 



CSIR First Women DG                                                             -       Nallathamby Kalaiselvi 
SEBI First Women Chairman                                                       -       Madhvi Puri Butch
ONGC First Women Chairman                                                       -       Alka Mittal
ONGC Interim Chairman                                                           -       Rajesh Srivastava 
ZSI First Women chairman                                                        -       Dhrati Bannerjee   
GSI DG                                                                          -       S. Raju   
ISRO 10th President                                                             -       S. Somnath
NITI Aayog                                                                      -       Suman Bery Vice President, Parmeshwar Aiyyer CEO
Chief Economic Adviser                                                          -       Anant Nageshvaran
FATF head                                                                       -       T. Rajakumar
CJI                                                                             -       UU Lalit, Next 50th DY Chandrachud
RBI Governor                                                                    -       25th Shaktikanta Das. Palm Tree and Bengal Tiger symbol
FIFA President                                                                  -       Gianni Infantino 
DMRC MD                                                                         -       Vikas Kumar 
Payments Counsil of India(PCI) Chairman                                         -       Vishwas Patel 
National Informatics Centre NIC DG                                              -       Rajesh Gera 
Bureau of Civil Aviation Security DG                                            -       Zulfiqar Hasan 
SSB DG                                                                          -       Sujoy Lal Thaosen, Nepal Bhutan
CEO of Prasar Bharati                                                           -       Mayank Kumar Agarwal(CEO Doordarshan) .Doordarshan + AIR (Broadcaster)
MNREGA Lokpal                                                                   -       N.J. Ojha
ITBP Director General                                                           -       Sujoy Lal Thaosen 


International Aluminium Institute Chairman                                      -       Satish Pai 

Airtel MD                                                                       -       Gopal Vittal 